駆逐イ級	i-class_destroyer	DD
萌化駆逐イ級	kuchiku_i-kyuu	DD
駆逐ロ級	ro-class_destroyer	DD
駆逐ハ級	ha-class_destroyer	DD
駆逐ニ級	ni-class_destroyer	DD
駆逐ナ級	na-class_destroyer	DD
駆逐棲姫	destroyer_hime	DD
防空棲姫	air_defense_hime	DD
PT小鬼群	pt_imp_group	Other
駆逐水鬼	destroyer_water_oni	DD
駆逐古鬼	ancient_destroyer_oni	DD
駆逐古姫	ancient_destroyer_hime	DD
深海雨雲姫	abyssal_nimbus_hime	DD
軽巡ホ級	ho-class_light_cruiser	CL (CLT, CT, CLV)
軽巡ヘ級	he-class_light_cruiser	CL (CLT, CT, CLV)
軽巡ト級	to-class_light_cruiser	CL (CLT, CT, CLV)
軽巡ツ級	tsu-class_light_cruiser	CL (CLT, CT, CLV)
軽巡棲鬼	light_cruiser_oni	CL (CLT, CT, CLV)
軽巡棲姫	light_cruiser_hime	CL (CLT, CT, CLV)
雷巡チ級	chi-class_torpedo_cruiser	CL (CLT, CT, CLV)
重巡リ級	ri-class_heavy_cruiser	CA
重巡ネ級	ne-class_heavy_cruiser	CA
重巡棲姫	heavy_cruiser_hime	CA
重巡夏姫	heavy_cruiser_summer_hime	CA
軽母ヌ級	nu-class_light_aircraft_carrier	CVL (CVE)
護衛棲姫	escort_hime	CVL (CVE)
水母棲姫	seaplane_tender_hime	AV
水母水姫	seaplane_tender_water_hime	AV
空母ヲ級	wo-class_aircraft_carrier	CV
空母棲鬼	aircraft_carrier_oni	CV
空母夏鬼	aircraft_carrier_summer_oni	CV
空母棲姫	aircraft_carrier_hime	CV
空母夏姬	aircraft_carrier_summer_hime	CV
空母水鬼	aircraft_carrier_water_oni	CV
深海海月姫	abyssal_jellyfish_hime	CV
輸送ワ級	wa-class_transport_ship	Other
潜水カ級	ka-class_submarine	SS (SSV)
潜水ソ級	so-class_submarine	SS (SSV)
潜水ヨ級	yo-class_submarine	SS (SSV)
潜水棲姫	submarine_hime	SS (SSV)
潜水新栖姬	submarine_new_hime	SS (SSV)
戦艦ル級	ru-class_battleship	BB (BBV)
戦艦タ級	ta-class_battleship	BB (BBV)
戦艦棲姫	battleship_hime	BB (BBV)
戦艦夏姫	battleship_summer_hime	BB (BBV)
戦艦水鬼	battleship_water_oni	BB (BBV)
战舰法栖姬	french_battleship_hime	BB (BBV)
戦艦レ級	re-class_battleship	BB (BBV)
装甲空母鬼	armored_aircraft_carrier_oni	BB (BBV)
装甲空母姫	armored_aircraft_carrier_hime	BB (BBV)
南方棲鬼	southern_ocean_oni	BB (BBV)
南方棲戦鬼	southern_ocean_war_oni	BB (BBV)
南方棲戦姫	southern_ocean_war_hime	BB (BBV)
泊地棲鬼	anchorage_oni	BB (BBV)
泊地棲姫	anchorage_hime	BB (BBV)
深海双子栖姬（黑）	abyssal_twin_hime_%28black%29	BB (BBV)
深海双子栖姬（白）	abyssal_twin_hime_%28white%29	BB (BBV)
北方水姫	northern_water_hime	BB (BBV)
欧州棲姫	european_hime	BB (BBV)
深海日棲姫	abyssal_sun_hime	AV
飛行場姫	airfield_hime	Installation
港湾棲姫	seaport_hime	Installation
港湾夏姫	seaport_summer_hime	Installation
離島棲鬼	isolated_island_oni	Installation
北方棲姫	northern_ocean_hime	Installation
中間棲姫	midway_hime	Installation
港湾水鬼	seaport_water_oni	Installation
泊地水鬼	anchorage_water_oni	Installation
集積地棲姫	supply_depot_hime	Installation
集积地夏姬	supply_depot_summer_hime	Installation
離島棲姫	isolated_island_hime	Installation
砲台小鬼	artillery_imp	Installation
中枢棲姫	central_hime	Installation
リコリス棲姫	lycoris_hime	Installation
北端上陆姬	northernmost_landing_hime	Installation
北方栖妹	northern_little_sister	Installation
浮遊要塞	floating_fortress_%28kantai_collection%29	Other
護衛要塞	escort_fortress_%28kantai_collection%29	Other
深海攻击哨戒鹰	abyssal_patrolling_attack_hawk	Other
深海舰载机	enemy_aircraft_%28kantai_collection%29	Other
深海浮轮	enemy_lifebuoy_%28kantai_collection%29	Other
深海忌雷	enemy_naval_mine_%28kantai_collection%29	Other
深海鶴棲姫	abyssal_crane_hime	CV
太平洋深海棲姫	abyssal_pacific_hime	BB (BBV)